R 7680 4320
NO assets/white.xpm
SO assets/white.xpm
WE assets/white.xpm
EA assets/white.xpm

S assets/white.xpm
F assets/white.xpm
C assets/white.xpm

MC assets/notomorrow.wav

1111111111111111111111
1001010100010000001001
1010000100010000001001
1010000100011111011001
1000000100010100000001
1011000000000100000001
1000000000000100000001
1111010000000100000001
1000010000000100000001
1000011110000000000001
1000000000000000000001
1000000000000101001011
1000000000000101001001
1000000000110101001111
1000000100010001000001
1000000100111101000001
1111011110101101000001
1000000000100000000001
111100000010101000W001
1001011110001010000001
1001110000101010000001
1111111111111111111111