B
R 1920 1080
NO assets/bonus_wall.xpm 1200 1200
SO assets/bonus_wall.xpm 1200 1200
EA assets/bonus_wall.xpm 1200 1200
WE assets/bonus_wall.xpm 1200 1200

C assets/bonus_ceil.xpm 626 626
F assets/bonus_floor.xpm 512 512

S assets/bonus_grass.xpm 8000 3951
S assets/bonus_barrel_dynamite.xpm 2325 3289

    11111111111111111111111111111
        1000000000110000000000001
        1111000001110030002000301
        1101000000000000000000001
111111111110000001110000000000001
100000000011000001110111110111111
111101111111110111000000100011
111101111110110111010100100001
110000001101010111000000100011
10002000000000001100000010001
10000000000000001101010010001
11000001110101011111011110N0111
11110111 1110101 101111010001
11111111 1111111 11111111111111
1
1