BONUS
R 600 400
NO assets/bonus_wall.xpm 1200 1200
SO assets/bonus_wall.xpm 1200 1200
WE assets/bonus_wall.xpm 1200 1200
EA assets/bonus_wall.xpm 1200 1200

C assets/bonus_ceil.xpm 626 626
F assets/bonus_floor.xpm 512 512

S assets/bonus_grass.xpm 8000 3951
S assets/bonus_barrel_dynamite.xpm 2325 3289

        1111111111111111111111111
        1000000000110000000000001
        1011000001110030002000301
        1001000000000000000000001
111111111011000001110000000000001
100000000011000001110111110111111
11110111111111011100000010001
11110111111111011101010010001
11000000110101011100000010001
10002000000000001100000010001
10000000000000001101010010001
11000001110101011111011110N0111
11110111 1110101 101111010001
11111111 1111111 111111111111