R 600 400
NO assets/redbrick.xpm
SO assets/redbrick.xpm
WE assets/redbrick.xpm
EA assets/redbrick.xpm

S assets/barrel.xpm
C assets/redbrick.xpm
F assets/redbrick.xpm

 111
11S1111111111111111
1001000100001000001
1011010101101011101
1000010000101010001
1111111110100010111
1000000011111110001
1011111011111110101
1010001000000010101
1011100011111011101
1000111110100000001
1010000100001111101
1011110111111000101
1000100100010010101
11101011010101101111
10001000010100100021
10111111110110111011
1010000000001010001
1010111111111011111
1010000000000000001
1111111111111111111