NO maps/textures/faithful/copper_grate.xpm42
WE maps/textures/faithful/copper_grate.xpm42
SO maps/textures/faithful/copper_grate.xpm42
EA maps/textures/faithful/copper_grate.xpm42
F maps/textures/faithful/copper_block.xpm42
C maps/textures/faithful/copper_block.xpm42
S maps/textures/maze/win.xpm42

111111111111111111111111111111111111111111
1E0001010001000000000001000000000000010001
110101010101010111011111010111111111010101
 10100010100010100010000010001000001010101
 10111010111110101110111111101110101011101
 10001010000010100010000000100010101010001
 10101011111010111111101111111010101010101
 10101010001010000000001000001010101010101
 10101110101011111111111011101010101010101
 10101000101000100000100010000010100000101
 10101011101110111110101111111011111011111
 10100010100010000000101000001010001010001
 10111110111011111110101011101110101110101
 10000000101000000010100010101000100000101
 11111110101111101110111110101011111111101
 10000010100010100010000010101000000000101
 10111010101010111011111010101110111111101
 10001000101000001000000000101000100000001
 11111110101111101111111111101011101111111
 10000010001010000000100000001010001000101
 10111011111010111111101111101010111011101
 10001000001000001000001000001010000010001
 10101111101110111011111011111011111110101
 10101000100010100010001010000010000000101
 11101011111010101110101010111111111110111
 10001000000010100010101010001000000010001
 10111110111111111010101011101110111011101
 10000010100000001000101000100000100010001
 11111010101111101111101110111111101110101
 10000010100010100000001010100000101000101
 10111110111010101111111010101110101011101
 10100010100010001000001000100010101000101
 10101010101110111011101011111011101010101
 10101010001000100010101010000010001010101
 10101011101111101110101011101010111110101
 10101000001000001000101010001010100010101
 10101111111011111010101010101110101010101
 10101000000010000010101000101000101000101
 101110111111111111101011111110111011111011
 100000000000000000001000000000000010000021
 111111111111111111111111111111111111111111
