NO maps/textures/faithful/copper_grate.xpm42
SO maps/textures/faithful/copper_grate.xpm42
WE maps/textures/faithful/copper_grate.xpm42
EA maps/textures/faithful/copper_grate.xpm42

S maps/textures/maze/win.xpm42
C maps/textures/faithful/copper_block.xpm42
F maps/textures/faithful/copper_block.xpm42

111111111111111111111111111111111111111111
1E0000000100000000000100000000000100000101
110111110101111111110101110111110101110101
 10101000101000001010100010001000101010001
 10101011101011101010111011101011101011101
 10100010000000101000100000101000101000101
 10101110111110101110111111101110101010101
 10100010100010100010000000001010001010101
 10111011101010111011111111111011111010101
 10001000101010100010000010001000001010001
 10101110101011101111101010111010111011111
 10101000101000100000101000100010001000001
 10101110101110101110101111101111101111101
 10100010001010100010100010001000100010001
 11111011111010111010111010111010111010111
 10000010001000100010100010001010101010101
 10111111101011111110101111101010101010101
 10000000101000000000100000100010101000101
 10111110101111111111111011111110101111101
 10100000100010000000001000000010000010001
 10101111111010111011101110111111111010111
 10100010000010101010100000100000001010001
 10111010111110101010111110101111101011101
 10100010001000101010000000100010101000001
 10101110101011101011111111111010101111101
 10100010101000001000000000001000100010001
 10111011101111101111111111101110101110111
 10101000100000101000100000001010100000101
 10101110111011101011101111101010111111101
 10100010001010001000100000100010100000001
 10111011101010111110111110111110101111101
 10100000101010001000100010000000100000101
 10101111101011101010111011111111101111101
 10001000001010001010000000001000001000101
 11101011111010111011111111101111111010101
 10101010000010100010000000100000100010001
 10101010111110101111101011111110101111101
 10001010100000100000101000100010001010001
 111110101011111111101011101010111110101111
 100000100000000000001000100010000000000021
 111111111111111111111111111111111111111111
